#####################
#                   #
#   ####  #         #
#      #######      #
#      #            #
#      #   @        #
#                   #
#         #####     #
#                   #
#####################